22222222222222222222222
20000000000000000000002
20B00B000B0000B000B0002
20011100000000000111002
20012100000000000121002
20000000000000000000002
20000000000000000000002
20000002222222200000002
20000001011110100000002
20000002222222200000002
20000000000000000000002
20000000000000000000002
22222200000000000222222
20000100000000000100002
20000100000000000100002
20000000011100A00000002
200000C001C100000000002
22222222222222222222222